11111111111
1C10C0100E1
10101010001
10101010001
1P001C000C1
11111111111
