1111111111111111
1P100000C1000001
1010010001001001
1010010001001001
10C00100000C10E1
1111111111111111